####=###################################
#        #  #                          #
#         x                            #
#        #  #                          #
###########################            #
#               x                      #
#               ###        #           #
#               #          #           #
#               # $        #     $     #
########################################