#########################################
##               ?                     ##
||X       #  $          #              ##
#############################          ##
##        @      x                     ##
##               #            #        ##
##               #     $      #    $   ##
#########################################