#########################################
##               ?                     ##
||x       #  $          #              ##
#############################          ##
##        @      x                     ##
##               #            #        ##
##               #     $      #    $   ##
#########################################