####################################
#    #  #                          #
#      x                           #
#    #  #                          #
######################             #
#               x                  #
#               ###        #       #
#               #          #       #
#               # $        #     $ #
####################################