##################################
#                  $            ##
#################               ##
#       x?                      ##
#       #                       ##
#       ##########################
#                               ##
#                              ?||
##################################