######################
##         @  #     ##
######           ?  ||
##            #     ##
##            #     ##
##  <(^.^)> ? #     ##
######################