####################################
##                           $    ##
##                                ||
##      ?             ####        ##
##                       #        ##
##                       #        ##
#################        #        ##
##              ? x      #        ##
####################################