###############################
#    #  #                     #
#                             #
#                             #
#    #  #                     #
#########################     #
#                             #
#                       ### ###
#          ##########   #     #
#          #            #     #
#          #            #     #