###############################
#    #  #                     #
#      x                      #
#    #  #                     #
#########################     #
#           x                 #
#                       ### ###
#          ##########   #     #
#          # $          #   $ #
###############################